*************************************************
*    **********                      ************
*               *****   ***    ****            **
* ******** **********   *** ** **** *** ****    *
*           ********    *** ** **** *** **   ****
* ** ****** ***         *** **  ***     **      *
* ** ****** *** ******  *** **  *****   **** ****
*     *****     ******          ******          *
*****       **********  ****************  ***** *
******* **************  ******            ****  *
*                               ********  *     *
* ** ********** ***     ***************** * *****
*    ***            ***********             *****
***  ********** **      ******  ***********     *
***             *******                   *  ** *
*** *** *****   ******* *********  ******  **** *
*       *               ***        ******       *
**** ***** ******* ***  *** ***** ********* ** **
****        *****       *                       *
*************************************************
